6
36
523 180 1 2 3 4 5 6 7 270 271 272 416 524 525 64 65 66 67 68 69 70 71 72 73 74 75 41 23 24 25 26 27 28 139 140
54
523 180 1 2 3 4 5 6 7 8 9 10 359 361 362 557 106 107 108 363 364 365 366 367 368 369 370 371 372 373 374 375 376 377 378 111 112 113 379 380 381 382 73 74 75 41 23 24 25 26 27 28 139 140
32
523 180 1 2 3 4 5 6 7 8 29 30 31 32 33 34 35 36 20 37 38 39 40 41 23 24 25 26 27 28 139 140 
35
523 180 1 2 3 4 5 6 7 8 29 30 31 32 55 56 590 591 552 61 36 20 37 38 39 40 41 23 24 25 26 27 28 139 140
50
130 131 132 358 42 43 44 45 46 47 134 384 385 137 167 27 28 139 140 141 482 145 146 147 148 149 150 151 152 153 154 155 156 157 159 160 161 162 163 83 84 85 86 87 88 89 553 90 165 166
53
130 131 132 358 42 43 44 45 46 47 134 384 385 425 426 169 386 387 388 389 390 391 170 150 151 170 173 174 175 176 178 177 523 180 1 2 3 4 160 161 162 163 83 84 85 86 87 88 89 553 90 165 166 
115 150000000
