24
36
523 180 1 2 3 4 5 6 7 270 271 272 416 524 525 64 65 66 67 68 69 70 71 72 73 74 75 41 23 24 25 26 27 28 139 140
54
523 180 1 2 3 4 5 6 7 8 9 10 359 361 362 557 106 107 108 363 364 365 366 367 368 369 370 371 372 373 374 375 376 377 378 111 112 113 379 380 381 382 73 74 75 41 23 24 25 26 27 28 139 140
32
523 180 1 2 3 4 5 6 7 8 29 30 31 32 33 34 35 36 20 37 38 39 40 41 23 24 25 26 27 28 139 140 
35
523 180 1 2 3 4 5 6 7 8 29 30 31 32 55 56 590 591 552 61 36 20 37 38 39 40 41 23 24 25 26 27 28 139 140
50
130 131 132 358 42 43 44 45 46 47 134 384 385 137 167 27 28 139 140 141 482 145 146 147 148 149 150 151 152 153 154 155 156 157 159 160 161 162 163 83 84 85 86 87 88 89 553 90 165 166
53
130 131 132 358 42 43 44 45 46 47 134 384 385 425 426 169 386 387 388 389 390 391 170 150 151 170 173 174 175 176 178 177 523 180 1 2 3 4 160 161 162 163 83 84 85 86 87 88 89 553 90 165 166 
42
181 182 175 183 184 185 186 187 188 189 129 9 10 11 12 445 111 112 113 380 191 192 193 72 73 74 75 76 194 195 196 197 167 168 555 199 146 147 200 201 202 263
50
151 170 173 174 175 183 184 185 186 187 188 189 129 203 100 562 580 563 581 564 582 417 205 540 342 343 583 565 566 567 119 206 207 41 23 24 25 26 27 28 139 140 141 482 145 146 147 148 149 150
44
181 182 175 183 184 185 186 215 216 217 218 219 220 221 222 223 224 225 573 574 575 576 226 228 229 230 231 232 233 234 235 236 197 167 168 555 199 146 147 148 568 569 570 263
48
181 182 175 183 184 185 186 215 216 217 218 219 220 221 222 223 408 409 411 410 541 412 522 414 413 415 499 228 229 230 231 232 233 234 235 236 197 167 168 555 199 146 147 148 568 569 570 263
42
181 182 175 183 184 185 186 161 237 238 47 240 92 93 241 242 243 244 245 125 126 246 247 82 248 249 385 137 167 27 28 139 140 141 482 145 146 147 200 201 202 263
46
549 263 181 182 175 183 184 185 186 187 188 250 251 252 253 466 467 468 561 471 504 470 469 481 550 212 472 473 255 256 120 121 257 52 258 259 195 196 197 167 168 169 386 387 388 389
48
90 42 43 44 45 46 47 48 49 50 51 52 53 129 29 30 31 32 55 56 57 59 275 293 500 60 61 36 20 37 38 39 40 76 77 78 79 80 81 82 83 84 85 86 87 88 89 553
76
46 47 91 92 93 94 95 96 97 98 99 100 101 579 284 285 582 204 105 380 381 382 383 11 12 506 507 447 15 508 509 18 19 55 56 57 59 275 293 500 60 61 36 20 525 64 65 66 67 68 69 496 108 109 70 71 72 359 361 362 114 115 116 117 118 119 120 121 122 123 124 125 126 127 559 45
54
90 42 43 44 45 46 47 91 92 93 94 95 96 97 98 99 264 265 505 11 12 506 507 447 15 508 509 18 19 20 21 268 40 8 9 10 269 119 120 121 122 123 124 125 126 127 559 560 85 86 87 88 89 553
53
181 182 175 176 178 177 523 180 1 2 3 4 5 6 7 270 271 272 416 524 55 56 57 59 275 293 500 60 61 36 20 37 38 39 40 41 23 24 25 26 27 28 139 140 141 482 145 146 147 200 201 202 263
37
160 187 188 189 129 29 30 31 32 55 56 57 59 275 276 372 369 370 277 278 289 279 281 114 115 116 282 119 120 121 122 123 395 233 234 235 236
46
523 5 6 7 8 396 397 579 284 285 323 324 316 326 327 328 329 300 486 487 488 489 490 491 492 493 494 495 311 312 313 314 315 325 317 204 115 116 117 321 75 76 194 195 196 197
44
160 215 216 217 218 95 96 97 98 99 264 283 284 285 582 204 105 286 287 346 288 501 290 369 370 371 291 292 293 500 59 60 61 36 20 37 38 39 40 41 23 24 25 186
60
523 180 1 2 3 4 5 6 7 270 271 396 397 579 284 285 417 205 294 295 296 297 298 299 300 301 302 334 335 303 304 305 306 307 308 309 310 311 336 337 338 339 340 341 342 343 115 116 117 321 322 22 23 24 25 26 27 28 139 140
60
523 180 1 2 3 4 5 6 7 270 271 396 397 579 284 285 323 324 316 297 298 299 300 301 302 303 304 305 306 546 542 544 543 547 548 307 308 309 310 311 336 337 338 325 317 204 115 116 117 321 322 22 23 24 25 26 27 28 139 140
40
398 187 188 189 129 344 345 286 287 350 351 352 353 354 452 453 480 428 429 571 443 430 464 483 463 431 578 572 432 433 435 498 357 289 279 281 282 399 400 25
29 
398 187 188 189 129 344 345 286 287 394 348 459 458 558 354 356 462 456 457 460 349 461 497 503 281 282 399 400 25
23
129 344 345 286 287 394 348 459 458 558 354 356 462 456 457 460 349 461 497 503 281 282 399
115 150000000
