12
36
523 180 1 2 3 4 5 6 7 270 271 272 416 524 525 64 65 66 67 68 69 70 71 72 73 74 75 41 23 24 25 26 27 28 139 140
54
523 180 1 2 3 4 5 6 7 8 9 10 359 361 362 557 106 107 108 363 364 365 366 367 368 369 370 371 372 373 374 375 376 377 378 111 112 113 379 380 381 382 73 74 75 41 23 24 25 26 27 28 139 140
32
523 180 1 2 3 4 5 6 7 8 29 30 31 32 33 34 35 36 20 37 38 39 40 41 23 24 25 26 27 28 139 140 
35
523 180 1 2 3 4 5 6 7 8 29 30 31 32 55 56 590 591 552 61 36 20 37 38 39 40 41 23 24 25 26 27 28 139 140
50
130 131 132 358 42 43 44 45 46 47 134 384 385 137 167 27 28 139 140 141 482 145 146 147 148 149 150 151 152 153 154 155 156 157 159 160 161 162 163 83 84 85 86 87 88 89 553 90 165 166
53
130 131 132 358 42 43 44 45 46 47 134 384 385 425 426 169 386 387 388 389 390 391 170 150 151 170 173 174 175 176 178 177 523 180 1 2 3 4 160 161 162 163 83 84 85 86 87 88 89 553 90 165 166 
42
181 182 175 183 184 185 186 187 188 189 129 9 10 11 12 445 111 112 113 380 191 192 193 72 73 74 75 76 194 195 196 197 167 168 555 199 146 147 200 201 202 263
50
151 170 173 174 175 183 184 185 186 187 188 189 129 203 100 562 580 563 581 564 582 417 205 540 342 343 583 565 566 567 119 206 207 41 23 24 25 26 27 28 139 140 141 482 145 146 147 148 149 150
44
181 182 175 183 184 185 186 215 216 217 218 219 220 221 222 223 224 225 573 574 575 576 226 228 229 230 231 232 233 234 235 236 197 167 168 555 199 146 147 148 568 569 570 263
48
181 182 175 183 184 185 186 215 216 217 218 219 220 221 222 223 408 409 411 410 541 412 522 414 413 415 499 228 229 230 231 232 233 234 235 236 197 167 168 555 199 146 147 148 568 569 570 263
42
181 182 175 183 184 185 186 161 237 238 47 240 92 93 241 242 243 244 245 125 126 246 247 82 248 249 385 137 167 27 28 139 140 141 482 145 146 147 200 201 202 263
46
549 263 181 182 175 183 184 185 186 187 188 250 251 252 253 466 467 468 561 471 504 470 469 481 550 212 472 473 255 256 120 121 257 52 258 259 195 196 197 167 168 169 386 387 388 389
115 150000000
